Primer Name	Sequence	Pool	Length	Tm	GC%	Start	End
hku1_clade1_2_1_LEFT	1	GCAAGTAAACTATGATCCTCAGGAGT	26	42.31	60.85	322	348
hku1_clade1_2_1_RIGHT	1	TCCTCATTGGAATTCTGATCAAGCT	25	40	60.73	2253	2278
hku1_clade1_2_2_LEFT	2	AATGGTCAATGGCCACATAAGC	22	45.45	59.75	2106	2128
hku1_clade1_2_2_RIGHT	2	TGCTGCTGGTGTACCATTTTCT	22	45.45	60.67	4031	4053
hku1_clade1_2_3_LEFT	1	GCAAGAGCAGAGTTAGTAGCAGT	23	47.83	60.62	3891	3914
hku1_clade1_2_3_RIGHT	1	GTTTGCTATACCTAATCGCAGACG	24	45.83	60.16	5781	5805
hku1_clade1_2_4_LEFT	2	CAAGACCTGGACAATGTTCACCT	23	47.83	61	5323	5346
hku1_clade1_2_4_RIGHT	2	CCCGTGCAGGTTGTTGATTCTA	22	50	61.05	7359	7381
hku1_clade1_2_5_LEFT	1	ACCAAAAGAAAAACGAGGCCAA	22	40.91	59.68	7126	7148
hku1_clade1_2_5_RIGHT	1	AGGACTTTCAATTTATGTTGTGGTGT	26	34.62	60.12	9123	9149
hku1_clade1_2_6_LEFT	2	AGCAACATTCATCATACAACCTGTTG	26	38.46	61.01	8949	8975
hku1_clade1_2_6_RIGHT	2	TCTGATGCAATTATGACTCGGTGT	24	41.67	60.7	10935	10959
hku1_clade1_2_7_LEFT	1	CAGACTTGACAACAGGAGAAGCA	23	47.83	61	10700	10723
hku1_clade1_2_7_RIGHT	1	TCAGCACATTGGAATGAAACGTT	23	39.13	59.93	12752	12775
hku1_clade1_2_8_LEFT	2	AGCAGGTATAATGCGTGTACAGT	23	43.48	60.12	12573	12596
hku1_clade1_2_8_RIGHT	2	TGGCTGGGATGATATGTTACGC	22	50	60.73	14565	14587
hku1_clade1_2_9_LEFT	1	ACATAATAGCAACCGCCACACA	22	45.45	60.8	14530	14552
hku1_clade1_2_9_RIGHT	1	GAGATGGCAGTTGTTCCTGTGT	22	50	60.99	16383	16405
hku1_clade1_2_10_LEFT	2	ACCGTCGTCATCTATACGCTGA	22	50	61.24	16173	16195
hku1_clade1_2_10_RIGHT	2	GGGGATTTTTCTCTCTTTTAAACAGTGT	28	35.71	60.97	18129	18157
hku1_clade1_2_11_LEFT	1	ATAACTGGCACGCCACCTATTC	22	50	60.93	17979	18001
hku1_clade1_2_11_RIGHT	1	AGAATTCTGTTTCTGATGTTGCTTACA	27	33.33	60.26	19909	19936
hku1_clade1_2_12_LEFT	2	ACAGATGCTGTAGGAGGTTGGT	22	50	61.28	19749	19771
hku1_clade1_2_12_RIGHT	2	TGGTATCTCTGTAACCCAGACTATGT	26	42.31	61.03	21739	21765
hku1_clade1_2_13_LEFT	1	TCAGTAAATTCCAAACCAGCAGC	23	43.48	60	21507	21530
hku1_clade1_2_13_RIGHT	1	ACTGGTGATGTTGTTTTGGCATC	23	43.48	60.5	23580	23603
hku1_clade1_2_14_LEFT	2	ACCACATTACCTTGTGACTCCTC	23	47.83	60.25	23391	23414
hku1_clade1_2_14_RIGHT	2	GGTCCTGATGCTAGACAAGATGG	23	52.17	60.75	25377	25400
hku1_clade1_2_15_LEFT	1	GCCAATGCTTTAGTACCAACAACT	24	41.67	60.34	25146	25170
hku1_clade1_2_15_RIGHT	1	TTGTCGCTGTTGTTTGTGATGC	22	45.45	60.97	27221	27243
hku1_clade1_2_16_LEFT	2	TACATACGAGAGGCCATTGCTT	22	45.45	59.75	27083	27105
hku1_clade1_2_16_RIGHT	2	TAGTGGCTTGGCATGTAGTTCG	22	50	60.86	28994	29016
hku1_clade1_2_17_LEFT	1	GCACTAGCATCTAACATGGTATTAAACC	28	39.29	61.06	27920	27948
hku1_clade1_2_17_RIGHT	1	TCCATGCTTGTGAGTGTGGTTT	22	45.45	60.87	29916	29938