name	pool	seq	size	%gc	tm (use 65)	Start	End
hku1_clade1_2_1_LEFT	1	GCAAGTAAACTATGATCCTCAGGAGT	26	42.31	60.85	322	348
hku1_clade1_2_1_RIGHT	1	TCCTCATTGGAATTCTGATCAAGCT	25	40	60.73	2253	2278
hku1_clade1_2_2_LEFT	2	AATGGTCAATGGCCACATAAGC	22	45.45	59.75	2106	2128
hku1_clade1_2_2_RIGHT	2	TGCTGCTGGTGTACCATTTTCT	22	45.45	60.67	4015	4037
hku1_clade1_2_3_LEFT	1	GCAAGAGCAGAGTTAGTAGCAGT	23	47.83	60.62	3875	3898
hku1_clade1_2_3_RIGHT	1	GTTTGCTATACCTAATCGCAGACG	24	45.83	60.16	5762	5786
hku1_clade1_2_4_LEFT	2	CAAGACCTGGACAATGTTCACCT	23	47.83	61	5307	5330
hku1_clade1_2_4_RIGHT	2	CCCGTGCAGGTTGTTGATTCTA	22	50	61.05	7334	7356
hku1_clade1_2_5_LEFT	1	ACCAAAAGAAAAACGAGGCCAA	22	40.91	59.68	7101	7123
hku1_clade1_2_5_RIGHT	1	AGGACTTTCAATTTATGTTGTGGTGT	26	34.62	60.12	9098	9124
hku1_clade1_2_6_LEFT	2	AGCAACATTCATCATACAACCTGTTG	26	38.46	61.01	8924	8950
hku1_clade1_2_6_RIGHT	2	TCTGATGCAATTATGACTCGGTGT	24	41.67	60.7	10910	10934
hku1_clade1_2_7_LEFT	1	CAGACTTGACAACAGGAGAAGCA	23	47.83	61	10675	10698
hku1_clade1_2_7_RIGHT	1	TCAGCACATTGGAATGAAACGTT	23	39.13	59.93	12727	12750
hku1_clade1_2_8_LEFT	2	AGCAGGTATAATGCGTGTACAGT	23	43.48	60.12	12548	12571
hku1_clade1_2_8_RIGHT	2	TGGCTGGGATGATATGTTACGC	22	50	60.73	14540	14562
hku1_clade1_2_9_LEFT	1	ACATAATAGCAACCGCCACACA	22	45.45	60.8	14325	14347
hku1_clade1_2_9_RIGHT	1	GAGATGGCAGTTGTTCCTGTGT	22	50	60.99	16358	16380
hku1_clade1_2_10_LEFT	2	ACCGTCGTCATCTATACGCTGA	22	50	61.24	16148	16170
hku1_clade1_2_10_RIGHT	2	GGGGATTTTTCTCTCTTTTAAACAGTGT	28	35.71	60.97	18104	18132
hku1_clade1_2_11_LEFT	1	ATAACTGGCACGCCACCTATTC	22	50	60.93	17954	17976
hku1_clade1_2_11_RIGHT	1	AGAATTCTGTTTCTGATGTTGCTTACA	27	33.33	60.26	19884	19911
hku1_clade1_2_12_LEFT	2	ACAGATGCTGTAGGAGGTTGGT	22	50	61.28	19724	19746
hku1_clade1_2_12_RIGHT	2	TGGTATCTCTGTAACCCAGACTATGT	26	42.31	61.03	21714	21740
hku1_clade1_2_13_LEFT	1	TCAGTAAATTCCAAACCAGCAGC	23	43.48	60	21482	21505
hku1_clade1_2_13_RIGHT	1	ACTGGTGATGTTGTTTTGGCATC	23	43.48	60.5	23555	23578
hku1_clade1_2_14_LEFT	2	ACCACATTACCTTGTGACTCCTC	23	47.83	60.25	23366	23389
hku1_clade1_2_14_RIGHT	2	GGTCCTGATGCTAGACAAGATGG	23	52.17	60.75	25352	25375
hku1_clade1_2_15_LEFT	1	GCCAATGCTTTAGTACCAACAACT	24	41.67	60.34	25121	25145
hku1_clade1_2_15_RIGHT	1	TTGTCGCTGTTGTTTGTGATGC	22	45.45	60.97	27011	27033
hku1_clade1_2_16_LEFT	2	TACATACGAGAGGCCATTGCTT	22	45.45	59.75	26873	26895
hku1_clade1_2_16_RIGHT	2	TAGTGGCTTGGCATGTAGTTCG	22	50	60.86	28784	28806
hku1_clade1_2_17_LEFT	1	GCACTAGCATCTAACATGGTATTAAACC	28	39.29	61.06	27710	27738
hku1_clade1_2_17_RIGHT	1	TCCATGCTTGTGAGTGTGGTTT	22	45.45	60.87	29706	29728