Primer Name	Sequence	Pool	Length	Tm	GC%	Start	End
HKU1clade2_1.5_1_LEFT	TGATAGAGAGTGTCCTATTCCGACT	1	25	56.3	44	120	145
HKU1clade2_1.5_1_RIGHT	ACCTAGTGGTATGGATACTGCCT	1	23	56.9	47.8	1546	1569
HKU1clade2_1.5_2_LEFT	TGGTCAGCCCAAGAAGTTTTCT	2	22	56.7	45.5	1428	1450
HKU1clade2_1.5_2_RIGHT	ACTGGTTGTGGTTCTGCATGTT	2	22	57.4	45.5	2901	2923
HKU1clade2_1.5_3_LEFT	TAGCTAGGTCTCCAAACGTCCA	1	22	57.3	50	2763	2785
HKU1clade2_1.5_3_RIGHT	TGGATGTTTAGGTCCACACTGC	1	22	57.2	50	4198	4220
HKU1clade2_1.5_4_LEFT	TGAGATTCAGACAAAATAGGAGGCA	2	25	56	40	4022	4047
HKU1clade2_1.5_4_RIGHT	TCTGGTGCCAATTTTAGGGATCT	2	23	56.3	43.5	5522	5545
HKU1clade2_1.5_5_LEFT	ACACTACCTATAACTATAGTACTAAACTCACT	1	32	54.4	31.3	5366	5398
HKU1clade2_1.5_5_RIGHT	TGTGTCTCATTTAAACCATGACTGG	1	25	55.3	40	6837	6862
HKU1clade2_1.5_6_LEFT	ATTTGATCACCTTCGCCAGTGT	2	22	57	45.5	6649	6671
HKU1clade2_1.5_6_RIGHT	GGAGGTTTGCATTTGCTTATAGGC	2	24	56.7	45.8	8119	8143
HKU1clade2_1.5_7_LEFT	ACAAACACTCTTACTACTACCACACT	1	26	55.4	38.5	8002	8028
HKU1clade2_1.5_7_RIGHT	TGATGCTTTTCCTGTAGCCAAGT	1	23	56.8	43.5	9459	9482
HKU1clade2_1.5_8_LEFT	CCACCATTACATCCAGGAAGGT	2	22	56.7	50	9293	9315
HKU1clade2_1.5_8_RIGHT	TGTTGCTAAGCGTGTTTTAGGTG	2	23	55.9	43.5	10755	10778
HKU1clade2_1.5_9_LEFT	CCCTTCTTGGCTCTAGTTATGGC	1	23	57.3	52.2	10625	10648
HKU1clade2_1.5_9_RIGHT	TGGGTGGTATGTCTTACTATTGTGA	1	25	55.3	40	12116	12141
HKU1clade2_1.5_10_LEFT	ACGTTCAATACACTCATTTGCCAG	2	24	55.8	41.7	11947	11971
HKU1clade2_1.5_10_RIGHT	ATGACAGGCCGAATGTTCCATC	2	22	57.6	50	13413	13435
HKU1clade2_1.5_11_LEFT	ATCCCAACCCATAAGAACAGGG	1	22	56.8	50	13276	13298
HKU1clade2_1.5_11_RIGHT	AGTCGCGTGCCACATATAGTTC	1	22	57.1	50	14772	14794
HKU1clade2_1.5_12_LEFT	GGATTCTTTACAATCAGCATACTCACA	2	27	55.2	37	14653	14680
HKU1clade2_1.5_12_RIGHT	TGTGTACCTTTGAGTGCTATTCCA	2	24	56.1	41.7	16083	16107
HKU1clade2_1.5_13_LEFT	ACCATCAGCATCTTGAACAGTCT	1	23	56.3	43.5	15954	15977
HKU1clade2_1.5_13_RIGHT	TGATTGGTGTTACATTATGTGTACTTTGT	1	29	55.2	31	17427	17456
HKU1clade2_1.5_14_LEFT	AGCAGGAACAAAATATGAGAGCCA	2	24	56.7	41.7	17265	17289
HKU1clade2_1.5_14_RIGHT	AGGAAAATTGGTGTTAATGTATGTAGTGA	2	29	54.9	31	18757	18786
HKU1clade2_1.5_15_LEFT	GAACACGCCGCTTCTCTATAGG	1	22	57.4	54.5	18583	18605
HKU1clade2_1.5_15_RIGHT	TTGATGCTTTTAATCAACTTACTGCTG	1	27	54.4	33.3	20093	20120
HKU1clade2_1.5_16_LEFT	TGGACTCATACCATTGATCAAATTGG	2	26	55.4	38.5	19751	19777
HKU1clade2_1.5_16_RIGHT	ACTACATGGTTGCCTGATTTGTTT	2	24	55.3	37.5	21192	21216
HKU1clade2_1.5_17_LEFT	ACAACCAGCTTTATTACAACCATAGAC	1	27	55.3	37	21033	21060
HKU1clade2_1.5_17_RIGHT	AAGGCTCAGTTTAAACCATTTGCT	1	24	55.6	37.5	22488	22512
HKU1clade2_1.5_18_LEFT	ATCACCAGTAGCTACAGGCCAG	2	22	58.5	54.5	22350	22372
HKU1clade2_1.5_18_RIGHT	TGAGTGGTGATGATTGTTTTGTTTCA	2	26	55.6	34.6	23811	23837
HKU1clade2_1.5_19_LEFT	TGATAAGACGCCAATCTTTAGGAAGA	1	26	55.8	38.5	23693	23719
HKU1clade2_1.5_19_RIGHT	ACTGGTGACAATGACGATGAAGA	1	23	56.2	43.5	24854	24877
HKU1clade2_1.5_20_LEFT	TCGTCATTGTCACCAGTAACAACA	2	24	56.5	41.7	24860	24884
HKU1clade2_1.5_20_RIGHT	TCGTGCTGATTTTGCTTGCAAG	2	22	56.9	45.5	26473	26495
HKU1clade2_1.5_21_LEFT	TGTAGCAACTGAAACTCTGTCCA	1	23	56.1	43.5	26293	26316
HKU1clade2_1.5_21_RIGHT	AAACAGCCGTAAAGTCCGGTAC	1	22	57.3	50	27788	27810
HKU1clade2_1.5_22_LEFT	AATCCACAATCCAGGACGCG	2	20	57.9	55	26743	26763
HKU1clade2_1.5_22_RIGHT	TCCATGCTTGTGAGTGTGGTTT	2	22	57.2	45.5	28179	28201
