Primer Name	Sequence	Pool	Length	Tm 	GC%	Start	End
hku1clade2_2_1_LEFT	ATAGCGAGGGGTTACCACCTAG	1	22	60.94	54.55	385	407
hku1clade2_2_1_RIGHT	TTGCAGTTCGGTTATACGAGCC	1	22	61.17	50	2077	2099
hku1clade2_2_2_LEFT	AAAACTCCACCAACTGCCAGTT	2	22	61.07	45.45	2104	2126
hku1clade2_2_2_RIGHT	TGGTTTGGGTGTTACTATGGATGT	2	24	60.28	41.67	4116	4140
hku1clade2_2_3_LEFT	CTGAACCTGAGCCTCTAAAGCA	1	22	60.21	50	3664	3686
hku1clade2_2_3_RIGHT	AAAACACCACAGTTCCTCGCAT	1	22	61.19	45.45	5737	5759
hku1clade2_2_4_LEFT	GGGTTTCTGATACCAAAGAGTACTCA	2	26	60.74	42.31	5562	5588
hku1clade2_2_4_RIGHT	ACCATTTGATTGTCATTGGGATTTGA	2	26	60.46	34.62	7550	7576
hku1clade2_2_5_LEFT	ACTGTCCAAAATGCAAAACAACTCA	1	25	60.95	36	7354	7379
hku1clade2_2_5_RIGHT	CCTTCCTGGATGTAATGGTGGTAG	1	24	60.77	50	9379	9403
hku1clade2_2_6_LEFT	GCTTTGAACAAACAGCTCCACC	2	22	60.98	50	9173	9195
hku1clade2_2_6_RIGHT	ATCCTGCTCAATTACCTGCACC	2	22	60.87	50	11203	11225
hku1clade2_2_7_LEFT	ACTCTCATGTGTTGTCTGTCCC	1	22	60.14	50	12255	12277
hku1clade2_2_7_RIGHT	ACGCAATTTACAAAAACGCTTATACTC	1	27	60.21	33.33	14314	14341
hku1clade2_2_8_LEFT	TTCAACCCAACATTTAGATTCAGACA	2	26	59.67	34.62	14094	14120
hku1clade2_2_8_RIGHT	AGTCGCGTGCCACATATAGTTC	2	22	60.98	50	14861	14883
hku1clade2_2_9_LEFT	AAGTAAAGCTCTATTAAAAATAGGGCCT	1	28	59.55	32.14	15927	15955
hku1clade2_2_9_RIGHT	TTTATTCGCCAATCCTGCTGCA	1	22	61.39	45.45	16610	16632
hku1clade2_2_10_LEFT	GCATCAGCCAAATTTTTCTTTGCG	2	24	61.21	41.67	16464	16488
hku1clade2_2_10_RIGHT	TGAACGAACCTGATTATTCTGCCT	2	24	60.65	41.67	18406	18430
hku1clade2_2_11_LEFT	GTCGGCCATTATACGCAGCTAA	1	22	61.04	50	18211	18233
hku1clade2_2_11_RIGHT	ACAGGGTAATGTTGCTAAGGCA	1	22	60.14	45.45	21515	21537
hku1clade2_2_12_LEFT	AATAGGGACACTTGCCTCTTGC	2	22	60.8	50	20093	20115
hku1clade2_2_12_RIGHT	GGTTGCTAATGAATTGTCACGCC	2	23	61.22	47.83	23311	23334
hku1clade2_2_13_LEFT	AGCATTTTTAAGAGCCAAACAAAACA	1	26	59.84	30.77	23036	23062
hku1clade2_2_13_RIGHT	AGTCTTCCTAAAGATTGGCGTCT	1	23	59.74	43.48	23787	23810
hku1clade2_2_14_LEFT	AACACCATCTACAGTAAGCAAAACA	2	25	59.56	36	24875	24900
hku1clade2_2_14_RIGHT	TGTTGCTGTTGTTTGTGATGCT	2	22	60.01	40.91	25910	25932
hku1clade2_2_15_LEFT	ATACATACGAGAGGCCATTGCT	1	22	59.55	45.45	27110	27132
hku1clade2_2_15_RIGHT	TAGTGGCTTGGCATGTAGTTCG	1	22	60.86	50	29022	29044
hku1clade2_2_16_LEFT	GTAAAGAAGCCAGCCTGTAGCA	2	22	60.8	50	27923	27945
hku1clade2_2_16_RIGHT	TCCATGCTTGTGAGTGTGGTTT	2	22	60.87	45.45	29944	29966