Primer Name	Sequence	Pool	Length	Tm	GC%	Start	End
HKU1clade1_1.5_1_LEFT	GCAAGTAAACTATGATCCTCAGGAGT	1	26	56.2	42.3	322	348
HKU1clade1_1.5_1_RIGHT	AGGGTGTTAAACTTGGCACTGG	1	22	57.7	50	1816	1838
HKU1clade1_1.5_2_LEFT	GCTCTCAACAAGGCAGTATCCA	2	22	57	50	1627	1649
HKU1clade1_1.5_2_RIGHT	TGAAATGTATGTTAAATGGCCTTGGT	2	26	55.4	34.6	3082	3108
HKU1clade1_1.5_3_LEFT	TGTGACCCCCATACTCATCACA	1	22	57.8	50	2950	2972
HKU1clade1_1.5_3_RIGHT	TCAGTTGCAGGTTGCTAATGCT	1	22	57.2	45.5	4391	4413
HKU1clade1_1.5_4_LEFT	ACGAAGAACCACATTGTGAACCT	2	23	56.9	43.5	4276	4299
HKU1clade1_1.5_4_RIGHT	GGCAGTTCTGGCTTTTTGCAAT	2	22	57.1	45.5	5740	5762
HKU1clade1_1.5_5_LEFT	ACAACGACCTTCTTTTGAGGACA	1	23	56.6	43.5	5352	5375
HKU1clade1_1.5_5_RIGHT	TGTATCTCTTGGTTTGGGCACAT	1	23	56.6	43.5	6826	6849
HKU1clade1_1.5_6_LEFT	ATCTGACAGAAAAGGTGGTTTATACC	2	26	54.9	38.5	6680	6706
HKU1clade1_1.5_6_RIGHT	GTTGGTGATAGTCTTGTAAACACTTGT	2	27	55.4	37	8175	8202
HKU1clade1_1.5_7_LEFT	CCAGTCATGGTTTAAATGAGACACA	1	25	55.3	40	8056	8081
HKU1clade1_1.5_7_RIGHT	TCAACCTTTGAACCTCGCTCAG	1	22	57.3	50	9488	9510
HKU1clade1_1.5_8_LEFT	CCTATAAGCAAGTGCAAACCTCC	2	23	55.9	47.8	9352	9375
HKU1clade1_1.5_8_RIGHT	TGCAGCGTGTTATGCTTAAAGC	2	22	56.5	45.5	10804	10826
HKU1clade1_1.5_9_LEFT	ACAGACTTGACAACAGGAGAAGC	1	23	57	47.8	10687	10710
HKU1clade1_1.5_9_RIGHT	GGGACAGACAACACATGAGAGT	1	22	56.7	50	12117	12139
HKU1clade1_1.5_10_LEFT	AGAACCTTGAGCAGAATCAACAGT	2	24	56.5	41.7	11952	11976
HKU1clade1_1.5_10_RIGHT	ACGGAAGCCTTTGTTGTGTTGT	2	22	57.8	45.5	13485	13507
HKU1clade1_1.5_11_LEFT	ACCACCCAAATATAATTTGGTGACAT	1	26	55.1	34.6	13365	13391
HKU1clade1_1.5_11_RIGHT	AGGCATTATCATTTGAGGAGCAGA	1	24	56.3	41.7	14789	14813
HKU1clade1_1.5_12_LEFT	GAACACCACGAGTAGCTGCTAT	2	22	56.7	50	14606	14628
HKU1clade1_1.5_12_RIGHT	CGTATAGATGACGACGGTAATAAATTGG	2	28	55.3	39.3	16151	16179
HKU1clade1_1.5_13_LEFT	TGGCACACGACTACCATCAATA	1	22	56	45.5	16014	16036
HKU1clade1_1.5_13_RIGHT	AAACTGGAACGTATGGCAGACC	1	22	57.4	50	17485	17507
HKU1clade1_1.5_14_LEFT	CTGGAATAGCATTCAAAGGTACACA	2	25	55.2	40	17314	17339
HKU1clade1_1.5_14_RIGHT	TGAATTGGCACCTTCTGACGTT	2	22	57.1	45.5	18839	18861
HKU1clade1_1.5_15_LEFT	ACAAAGTACACATAATGTAACACCAATCA	1	29	55.2	31	18659	18688
HKU1clade1_1.5_15_RIGHT	CAAGTTTATCCTATTTGTGCATGTGTTT	1	28	54.8	32.1	20185	20213
HKU1clade1_1.5_16_LEFT	TGTGACACAAAACCAAAAAGGCA	2	23	56.2	39.1	20069	20092
HKU1clade1_1.5_16_RIGHT	GCTGCTGGTTTGGAATTTACTGA	2	23	55.9	43.5	21222	21245
HKU1clade1_1.5_17_LEFT	GCCTTAGCAACATTACCCTGTACA	1	24	57	45.8	21378	21402
HKU1clade1_1.5_17_RIGHT	AGCCACTGTGTTTTTGTTTTGGT	1	23	56.2	39.1	22828	22851
HKU1clade1_1.5_18_LEFT	TTGTAACCAAACCAAAAGTAGCCTT	2	25	55.3	36	22708	22733
HKU1clade1_1.5_18_RIGHT	AAGTCGTGTTGGTGTTGATGCT	2	22	57.3	45.5	24173	24195
HKU1clade1_1.5_19_LEFT	AGCTGCAACAACATCATCAGGT	1	22	57.3	45.5	24008	24030
HKU1clade1_1.5_19_RIGHT	AATGGGCATATGCTCCATGGTG	1	22	57.8	50	25537	25559
HKU1clade1_1.5_20_LEFT	CCATCTTGTCTAGCATCAGGACC	2	23	57	52.2	25365	25388
HKU1clade1_1.5_20_RIGHT	ACTGGTGACAATGACGATGAAGA	2	23	56.2	43.5	26451	26474
HKU1clade1_1.5_21_LEFT	TCGTCATTGTCACCAGTAACAACA	1	24	56.5	41.7	26457	26481
HKU1clade1_1.5_21_RIGHT	TGGTGTTAATAATTCTTGGTGTAGGC	1	26	55.3	38.5	23981	24007
HKU1clade1_1.5_22_LEFT	GGTACAAAACCATCTCCACAAACT	2	24	55.5	41.7	28071	28095
HKU1clade1_1.5_22_RIGHT	CTTGGACAAGAATGGCATGTGC	2	22	57.1	50	29500	29522
HKU1clade1_1.5_23_LEFT	CAGGACGCGGTGACCAATATAT	1	22	56.8	50	28381	28403
HKU1clade1_1.5_23_RIGHT	TCCATGCTTGTGAGTGTGGTTT	1	22	57.2	45.5	29806	29828
