name	pool	seq	size	%gc	tm (use 65)	Start	End
hku1clade2_1.5_1_LEFT	1	TGATAGAGAGTGTCCTATTCCGACT	25	44	60.55	120	145
hku1clade2_1.5_1_RIGHT	1	ACCTAGTGGTATGGATACTGCCT	23	47.83	60.38	1546	1569
hku1clade2_1.5_2_LEFT	2	TGGTCAGCCCAAGAAGTTTTCT	22	45.45	60.28	1428	1450
hku1clade2_1.5_2_RIGHT	2	ACTGGTTGTGGTTCTGCATGTT	22	45.45	61.13	2901	2923
hku1clade2_1.5_3_LEFT	1	TAGCTAGGTCTCCAAACGTCCA	22	50	60.74	2763	2785
hku1clade2_1.5_3_RIGHT	1	TGGATGTTTAGGTCCACACTGC	22	50	60.73	4198	4220
hku1clade2_1.5_4_LEFT	2	TGAGATTCAGACAAAATAGGAGGCA	25	40	60.43	4022	4047
hku1clade2_1.5_4_RIGHT	2	TCTGGTGCCAATTTTAGGGATCT	23	43.48	59.99	5611	5634
hku1clade2_1.5_5_LEFT	1	ACACTACCTATAACTATAGTACTAAACTCACT	32	31.25	59.93	5455	5487
hku1clade2_1.5_5_RIGHT	1	TGTGTCTCATTTAAACCATGACTGG	25	40	59.91	6926	6951
hku1clade2_1.5_6_LEFT	2	ATTTGATCACCTTCGCCAGTGT	22	45.45	60.74	6738	6760
hku1clade2_1.5_6_RIGHT	2	GGAGGTTTGCATTTGCTTATAGGC	24	45.83	61.05	8208	8232
hku1clade2_1.5_7_LEFT	1	ACAAACACTCTTACTACTACCACACT	26	38.46	60.12	8091	8117
hku1clade2_1.5_7_RIGHT	1	TGATGCTTTTCCTGTAGCCAAGT	23	43.48	60.76	9548	9571
hku1clade2_1.5_8_LEFT	2	CCACCATTACATCCAGGAAGGT	22	50	59.94	9832	9854
hku1clade2_1.5_8_RIGHT	2	TGTTGCTAAGCGTGTTTTAGGTG	23	43.48	60.25	10844	10867
hku1clade2_1.5_9_LEFT	1	CCCTTCTTGGCTCTAGTTATGGC	23	52.17	61	10714	10737
hku1clade2_1.5_9_RIGHT	1	TGGGTGGTATGTCTTACTATTGTGA	25	40	59.67	12205	12230
hku1clade2_1.5_10_LEFT	2	ACGTTCAATACACTCATTTGCCAG	24	41.67	60.4	12036	12060
hku1clade2_1.5_10_RIGHT	2	ATGACAGGCCGAATGTTCCATC	22	50	61.19	13502	13524
hku1clade2_1.5_11_LEFT	1	ATCCCAACCCATAAGAACAGGG	22	50	59.94	13365	13387
hku1clade2_1.5_11_RIGHT	1	AGTCGCGTGCCACATATAGTTC	22	50	60.98	14861	14883
hku1clade2_1.5_12_LEFT	2	GGATTCTTTACAATCAGCATACTCACA	27	37.04	60.21	14742	14769
hku1clade2_1.5_12_RIGHT	2	TGTGTACCTTTGAGTGCTATTCCA	24	41.67	60.28	16172	16196
hku1clade2_1.5_13_LEFT	1	ACCATCAGCATCTTGAACAGTCT	23	43.48	60.25	16043	16066
hku1clade2_1.5_13_RIGHT	1	TGATTGGTGTTACATTATGTGTACTTTGT	29	31.03	60.62	17516	17545
hku1clade2_1.5_14_LEFT	2	AGCAGGAACAAAATATGAGAGCCA	24	41.67	60.89	17534	17558
hku1clade2_1.5_14_RIGHT	2	AGGAAAATTGGTGTTAATGTATGTAGTGA	29	31.03	60.22	18846	18875
hku1clade2_1.5_15_LEFT	1	GAACACGCCGCTTCTCTATAGG	22	54.55	61.04	18672	18694
hku1clade2_1.5_15_RIGHT	1	TTGATGCTTTTAATCAACTTACTGCTG	27	33.33	59.68	20182	20209
hku1clade2_1.5_16_LEFT	2	TGGACTCATACCATTGATCAAATTGG	26	38.46	60.12	19840	19866
hku1clade2_1.5_16_RIGHT	2	ACTACATGGTTGCCTGATTTGTTT	24	37.5	59.73	21281	21305
hku1clade2_1.5_17_LEFT	1	ACAACCAGCTTTATTACAACCATAGAC	27	37.04	60.37	21122	21149
hku1clade2_1.5_17_RIGHT	1	AAGGCTCAGTTTAAACCATTTGCT	24	37.5	59.98	22577	22601
hku1clade2_1.5_18_LEFT	2	ATCACCAGTAGCTACAGGCCAG	22	54.55	61.73	22439	22461
hku1clade2_1.5_18_RIGHT	2	TGAGTGGTGATGATTGTTTTGTTTCA	26	34.62	60.57	23900	23926
hku1clade2_1.5_19_LEFT	1	TGATAAGACGCCAATCTTTAGGAAGA	26	38.46	60.57	23782	23808
hku1clade2_1.5_19_RIGHT	1	ACTGGTGACAATGACGATGAAGA	23	43.48	60.25	25281	25304
hku1clade2_1.5_20_LEFT	2	TCGTCATTGTCACCAGTAACAACA	24	41.67	61	25237	25261
hku1clade2_1.5_20_RIGHT	2	TCGTGCTGATTTTGCTTGCAAG	22	45.45	61.04	26900	26922
hku1clade2_1.5_21_LEFT	1	TGTAGCAACTGAAACTCTGTCCA	23	43.48	60.12	26293	26316
hku1clade2_1.5_21_RIGHT	1	AAACAGCCGTAAAGTCCGGTAC	22	50	61.05	28215	28237
hku1clade2_1.5_22_LEFT	2	AATCCACAATCCAGGACGCG	20	55	60.76	27170	27190
hku1clade2_1.5_22_RIGHT	2	TCCATGCTTGTGAGTGTGGTTT	22	45.45	60.87	28606	28628