Primer Name	Sequence	Pool	Length	Tm 	GC%	Start	End
hku1clade2_1.5_1_LEFT	TGATAGAGAGTGTCCTATTCCGACT	1	25	60.55	44	120	145
hku1clade2_1.5_1_RIGHT	ACCTAGTGGTATGGATACTGCCT	1	23	60.38	47.83	1546	1569
hku1clade2_1.5_2_LEFT	TGGTCAGCCCAAGAAGTTTTCT	2	22	60.28	45.45	1428	1450
hku1clade2_1.5_2_RIGHT	ACTGGTTGTGGTTCTGCATGTT	2	22	61.13	45.45	2901	2923
hku1clade2_1.5_3_LEFT	TAGCTAGGTCTCCAAACGTCCA	1	22	60.74	50	2763	2785
hku1clade2_1.5_3_RIGHT	TGGATGTTTAGGTCCACACTGC	1	22	60.73	50	4198	4220
hku1clade2_1.5_4_LEFT	TGAGATTCAGACAAAATAGGAGGCA	2	25	60.43	40	4022	4047
hku1clade2_1.5_4_RIGHT	TCTGGTGCCAATTTTAGGGATCT	2	23	59.99	43.48	5611	5634
hku1clade2_1.5_5_LEFT	ACACTACCTATAACTATAGTACTAAACTCACT	1	32	59.93	31.25	5455	5487
hku1clade2_1.5_5_RIGHT	TGTGTCTCATTTAAACCATGACTGG	1	25	59.91	40	6926	6951
hku1clade2_1.5_6_LEFT	ATTTGATCACCTTCGCCAGTGT	2	22	60.74	45.45	6738	6760
hku1clade2_1.5_6_RIGHT	GGAGGTTTGCATTTGCTTATAGGC	2	24	61.05	45.83	8208	8232
hku1clade2_1.5_7_LEFT	ACAAACACTCTTACTACTACCACACT	1	26	60.12	38.46	8091	8117
hku1clade2_1.5_7_RIGHT	TGATGCTTTTCCTGTAGCCAAGT	1	23	60.76	43.48	9548	9571
hku1clade2_1.5_8_LEFT	CCACCATTACATCCAGGAAGGT	2	22	59.94	50	9832	9854
hku1clade2_1.5_8_RIGHT	TGTTGCTAAGCGTGTTTTAGGTG	2	23	60.25	43.48	10844	10867
hku1clade2_1.5_9_LEFT	CCCTTCTTGGCTCTAGTTATGGC	1	23	61	52.17	10714	10737
hku1clade2_1.5_9_RIGHT	TGGGTGGTATGTCTTACTATTGTGA	1	25	59.67	40	12205	12230
hku1clade2_1.5_10_LEFT	ACGTTCAATACACTCATTTGCCAG	2	24	60.4	41.67	12036	12060
hku1clade2_1.5_10_RIGHT	ATGACAGGCCGAATGTTCCATC	2	22	61.19	50	13502	13524
hku1clade2_1.5_11_LEFT	ATCCCAACCCATAAGAACAGGG	1	22	59.94	50	13365	13387
hku1clade2_1.5_11_RIGHT	AGTCGCGTGCCACATATAGTTC	1	22	60.98	50	14861	14883
hku1clade2_1.5_12_LEFT	GGATTCTTTACAATCAGCATACTCACA	2	27	60.21	37.04	14742	14769
hku1clade2_1.5_12_RIGHT	TGTGTACCTTTGAGTGCTATTCCA	2	24	60.28	41.67	16172	16196
hku1clade2_1.5_13_LEFT	ACCATCAGCATCTTGAACAGTCT	1	23	60.25	43.48	16043	16066
hku1clade2_1.5_13_RIGHT	TGATTGGTGTTACATTATGTGTACTTTGT	1	29	60.62	31.03	17516	17545
hku1clade2_1.5_14_LEFT	AGCAGGAACAAAATATGAGAGCCA	2	24	60.89	41.67	17534	17558
hku1clade2_1.5_14_RIGHT	AGGAAAATTGGTGTTAATGTATGTAGTGA	2	29	60.22	31.03	18846	18875
hku1clade2_1.5_15_LEFT	GAACACGCCGCTTCTCTATAGG	1	22	61.04	54.55	18672	18694
hku1clade2_1.5_15_RIGHT	TTGATGCTTTTAATCAACTTACTGCTG	1	27	59.68	33.33	20182	20209
hku1clade2_1.5_16_LEFT	TGGACTCATACCATTGATCAAATTGG	2	26	60.12	38.46	19840	19866
hku1clade2_1.5_16_RIGHT	ACTACATGGTTGCCTGATTTGTTT	2	24	59.73	37.5	21281	21305
hku1clade2_1.5_17_LEFT	ACAACCAGCTTTATTACAACCATAGAC	1	27	60.37	37.04	21122	21149
hku1clade2_1.5_17_RIGHT	AAGGCTCAGTTTAAACCATTTGCT	1	24	59.98	37.5	22577	22601
hku1clade2_1.5_18_LEFT	ATCACCAGTAGCTACAGGCCAG	2	22	61.73	54.55	22439	22461
hku1clade2_1.5_18_RIGHT	TGAGTGGTGATGATTGTTTTGTTTCA	2	26	60.57	34.62	23900	23926
hku1clade2_1.5_19_LEFT	TGATAAGACGCCAATCTTTAGGAAGA	1	26	60.57	38.46	23782	23808
hku1clade2_1.5_19_RIGHT	ACTGGTGACAATGACGATGAAGA	1	23	60.25	43.48	25281	25304
hku1clade2_1.5_20_LEFT	TCGTCATTGTCACCAGTAACAACA	2	24	61	41.67	25237	25261
hku1clade2_1.5_20_RIGHT	TCGTGCTGATTTTGCTTGCAAG	2	22	61.04	45.45	26900	26922
hku1clade2_1.5_21_LEFT	TGTAGCAACTGAAACTCTGTCCA	1	23	60.12	43.48	26293	26316
hku1clade2_1.5_21_RIGHT	AAACAGCCGTAAAGTCCGGTAC	1	22	61.05	50	28215	28237
hku1clade2_1.5_22_LEFT	AATCCACAATCCAGGACGCG	2	20	60.76	55	27170	27190
hku1clade2_1.5_22_RIGHT	TCCATGCTTGTGAGTGTGGTTT	2	22	60.87	45.45	28606	28628