name	pool	seq	size	%gc	tm (use 65)	Start	End
hku1clade1_1.5_1_LEFT	1	GCAAGTAAACTATGATCCTCAGGAGT	26	42.31	60.85	322	348
hku1clade1_1.5_1_RIGHT	1	AGGGTGTTAAACTTGGCACTGG	22	50	61.2	1816	1838
hku1clade1_1.5_2_LEFT	2	GCTCTCAACAAGGCAGTATCCA	22	50	60.54	1627	1649
hku1clade1_1.5_2_RIGHT	2	TGAAATGTATGTTAAATGGCCTTGGT	26	34.62	60.23	3082	3108
hku1clade1_1.5_3_LEFT	1	TGTGACCCCCATACTCATCACA	22	50	61.02	2950	2972
hku1clade1_1.5_3_RIGHT	1	TCAGTTGCAGGTTGCTAATGCT	22	45.45	61	4391	4413
hku1clade1_1.5_4_LEFT	2	ACGAAGAACCACATTGTGAACCT	23	43.48	60.94	4276	4299
hku1clade1_1.5_4_RIGHT	2	GGCAGTTCTGGCTTTTTGCAAT	22	45.45	60.99	5743	5765
hku1clade1_1.5_5_LEFT	1	ACAACGACCTTCTTTTGAGGACA	23	43.48	60.62	5352	5375
hku1clade1_1.5_5_RIGHT	1	TGTATCTCTTGGTTTGGGCACAT	23	43.48	60.5	6829	6852
hku1clade1_1.5_6_LEFT	2	ATCTGACAGAAAAGGTGGTTTATACC	26	38.46	59.56	6683	6709
hku1clade1_1.5_6_RIGHT	2	GTTGGTGATAGTCTTGTAAACACTTGT	27	37.04	60.48	8187	8214
hku1clade1_1.5_7_LEFT	1	CCAGTCATGGTTTAAATGAGACACA	25	40	59.91	8068	8093
hku1clade1_1.5_7_RIGHT	1	TCAACCTTTGAACCTCGCTCAG	22	50	60.99	9500	9522
hku1clade1_1.5_8_LEFT	2	CCTATAAGCAAGTGCAAACCTCC	23	47.83	59.87	9364	9387
hku1clade1_1.5_8_RIGHT	2	TGCAGCGTGTTATGCTTAAAGC	22	45.45	60.59	10816	10838
hku1clade1_1.5_9_LEFT	1	ACAGACTTGACAACAGGAGAAGC	23	47.83	61	10699	10722
hku1clade1_1.5_9_RIGHT	1	GGGACAGACAACACATGAGAGT	22	50	60.14	12129	12151
hku1clade1_1.5_10_LEFT	2	AGAACCTTGAGCAGAATCAACAGT	24	41.67	60.77	11964	11988
hku1clade1_1.5_10_RIGHT	2	ACGGAAGCCTTTGTTGTGTTGT	22	45.45	61.64	13497	13519
hku1clade1_1.5_11_LEFT	1	ACCACCCAAATATAATTTGGTGACAT	26	34.62	59.78	13377	13403
hku1clade1_1.5_11_RIGHT	1	AGGCATTATCATTTGAGGAGCAGA	24	41.67	60.47	14801	14825
hku1clade1_1.5_12_LEFT	2	GAACACCACGAGTAGCTGCTAT	22	50	60.34	14618	14640
hku1clade1_1.5_12_RIGHT	2	CGTATAGATGACGACGGTAATAAATTGG	28	39.29	60.74	16163	16191
hku1clade1_1.5_13_LEFT	1	TGGCACACGACTACCATCAATA	22	45.45	59.68	16026	16048
hku1clade1_1.5_13_RIGHT	1	AAACTGGAACGTATGGCAGACC	22	50	61.06	17497	17519
hku1clade1_1.5_14_LEFT	2	CTGGAATAGCATTCAAAGGTACACA	25	40	59.73	17326	17351
hku1clade1_1.5_14_RIGHT	2	TGAATTGGCACCTTCTGACGTT	22	45.45	60.93	18851	18873
hku1clade1_1.5_15_LEFT	1	ACAAAGTACACATAATGTAACACCAATCA	29	31.03	60.62	18671	18700
hku1clade1_1.5_15_RIGHT	1	CAAGTTTATCCTATTTGTGCATGTGTTT	28	32.14	60.19	20197	20225
hku1clade1_1.5_16_LEFT	2	TGTGACACAAAACCAAAAAGGCA	23	39.13	60.5	20081	20104
hku1clade1_1.5_16_RIGHT	2	GCTGCTGGTTTGGAATTTACTGA	23	43.48	60	21507	21530
hku1clade1_1.5_17_LEFT	1	GCCTTAGCAACATTACCCTGTACA	24	45.83	61.19	21390	21414
hku1clade1_1.5_17_RIGHT	1	AGCCACTGTGTTTTTGTTTTGGT	23	39.13	60.5	22840	22863
hku1clade1_1.5_18_LEFT	2	TTGTAACCAAACCAAAAGTAGCCTT	25	36	59.96	22720	22745
hku1clade1_1.5_18_RIGHT	2	AAGTCGTGTTGGTGTTGATGCT	22	45.45	61.19	24185	24207
hku1clade1_1.5_19_LEFT	1	AGCTGCAACAACATCATCAGGT	22	45.45	61	24020	24042
hku1clade1_1.5_19_RIGHT	1	AATGGGCATATGCTCCATGGTG	22	50	61.27	25549	25571
hku1clade1_1.5_20_LEFT	2	CCATCTTGTCTAGCATCAGGACC	23	52.17	60.75	25377	25400
hku1clade1_1.5_20_RIGHT	2	ACTGGTGACAATGACGATGAAGA	23	43.48	60.25	26583	26606
hku1clade1_1.5_21_LEFT	1	TCGTCATTGTCACCAGTAACAACA	24	41.67	61	26559	26583
hku1clade1_1.5_21_RIGHT	1	TGGTGTTAATAATTCTTGGTGTAGGC	26	38.46	60.06	28296	28322
hku1clade1_1.5_22_LEFT	2	GGTACAAAACCATCTCCACAAACT	24	41.67	59.74	28181	28205
hku1clade1_1.5_22_RIGHT	2	CTTGGACAAGAATGGCATGTGC	22	50	60.85	29610	29632
hku1clade1_1.5_23_LEFT	1	CAGGACGCGGTGACCAATATAT	22	50	60.47	28491	28513
hku1clade1_1.5_23_RIGHT	1	TCCATGCTTGTGAGTGTGGTTT	22	45.45	60.87	29916	29938