name	pool	seq	size	%gc	tm (use 65)	Start	End
hku1clade2_2_1_LEFT	1	ATAGCGAGGGGTTACCACCTAG	22	54.55	60.94	146	168
hku1clade2_2_1_RIGHT	1	TTGCAGTTCGGTTATACGAGCC	22	50	61.17	2077	2099
hku1clade2_2_2_LEFT	2	AAAACTCCACCAACTGCCAGTT	22	45.45	61.07	1865	1887
hku1clade2_2_2_RIGHT	2	TGGTTTGGGTGTTACTATGGATGT	24	41.67	60.28	3896	3920
hku1clade2_2_3_LEFT	1	CTGAACCTGAGCCTCTAAAGCA	22	50	60.21	3664	3686
hku1clade2_2_3_RIGHT	1	AAAACACCACAGTTCCTCGCAT	22	45.45	61.19	5737	5759
hku1clade2_2_4_LEFT	2	GGGTTTCTGATACCAAAGAGTACTCA	26	42.31	60.74	5562	5588
hku1clade2_2_4_RIGHT	2	ACCATTTGATTGTCATTGGGATTTGA	26	34.62	60.46	7550	7576
hku1clade2_2_5_LEFT	1	ACTGTCCAAAATGCAAAACAACTCA	25	36	60.95	7354	7379
hku1clade2_2_5_RIGHT	1	CCTTCCTGGATGTAATGGTGGTAG	24	50	60.77	9379	9403
hku1clade2_2_6_LEFT	2	GCTTTGAACAAACAGCTCCACC	22	50	60.98	9173	9195
hku1clade2_2_6_RIGHT	2	ATCCTGCTCAATTACCTGCACC	22	50	60.87	11203	11225
hku1clade2_2_7_LEFT	1	ACTCTCATGTGTTGTCTGTCCC	22	50	60.14	10974	10996
hku1clade2_2_7_RIGHT	1	ACGCAATTTACAAAAACGCTTATACTC	27	33.33	60.21	13033	13060
hku1clade2_2_8_LEFT	2	TTCAACCCAACATTTAGATTCAGACA	26	34.62	59.67	12813	12839
hku1clade2_2_8_RIGHT	2	AGTCGCGTGCCACATATAGTTC	22	50	60.98	14861	14883
hku1clade2_2_9_LEFT	1	AAGTAAAGCTCTATTAAAAATAGGGCCT	28	32.14	59.55	14646	14674
hku1clade2_2_9_RIGHT	1	TTTATTCGCCAATCCTGCTGCA	22	45.45	61.39	16610	16632
hku1clade2_2_10_LEFT	2	GCATCAGCCAAATTTTTCTTTGCG	24	41.67	61.21	16464	16488
hku1clade2_2_10_RIGHT	2	TGAACGAACCTGATTATTCTGCCT	24	41.67	60.65	18406	18430
hku1clade2_2_11_LEFT	1	GTCGGCCATTATACGCAGCTAA	22	50	61.04	18211	18233
hku1clade2_2_11_RIGHT	1	ACAGGGTAATGTTGCTAAGGCA	22	45.45	60.14	20234	20256
hku1clade2_2_12_LEFT	2	AATAGGGACACTTGCCTCTTGC	22	50	60.8	20093	20115
hku1clade2_2_12_RIGHT	2	GGTTGCTAATGAATTGTCACGCC	23	47.83	61.22	22030	22053
hku1clade2_2_13_LEFT	1	AGCATTTTTAAGAGCCAAACAAAACA	26	30.77	59.84	21755	21781
hku1clade2_2_13_RIGHT	1	AGTCTTCCTAAAGATTGGCGTCT	23	43.48	59.74	23787	23810
hku1clade2_2_14_LEFT	2	AACACCATCTACAGTAAGCAAAACA	25	36	59.56	23594	23619
hku1clade2_2_14_RIGHT	2	TGTTGCTGTTGTTTGTGATGCT	22	40.91	60.01	25910	25932
hku1clade2_2_15_LEFT	1	ATACATACGAGAGGCCATTGCT	22	45.45	59.55	25772	25794
hku1clade2_2_15_RIGHT	1	TAGTGGCTTGGCATGTAGTTCG	22	50	60.86	27684	27706
hku1clade2_2_16_LEFT	2	GTAAAGAAGCCAGCCTGTAGCA	22	50	60.8	26585	26607
hku1clade2_2_16_RIGHT	2	TCCATGCTTGTGAGTGTGGTTT	22	45.45	60.87	28606	28628