Primer Name	Sequence	Pool	Length	Tm	GC%	Start	End
nl63995_curated_1.5_1_LEFT	TGTAAACTGGTTAGGCAAGTGTTG	1	24	59.98	41.67	90	114
nl63995_curated_1.5_1_RIGHT	AAGCATCTGGAACATCTGCACA	1	22	60.74	45.45	1587	1609
nl63995_curated_1.5_2_LEFT	GGATGCTTTTGTTGCCGCTATT	2	22	60.6	45.45	1472	1494
nl63995_curated_1.5_2_RIGHT	GCAACTGGCAATACACCATTACA	2	23	60.06	43.48	2892	2915
nl63995_curated_1.5_3_LEFT	ACTTTTCCTTGTGTTAGTTGTGTCAC	1	26	60.78	38.46	2691	2717
nl63995_curated_1.5_3_RIGHT	CCTGCTCCAACCTTAAGTGGAC	1	22	61.06	54.55	4207	4229
nl63995_curated_1.5_4_LEFT	TTGACTTTGTTGTCAATGCTGCT	2	23	60.12	39.13	4084	4107
nl63995_curated_1.5_4_RIGHT	ACCATCTTTAAGCACACTAGCACA	2	24	60.83	41.67	5556	5580
nl63995_curated_1.5_5_LEFT	CGACAATAATTGTTGGGTTAATGCAAC	1	27	60.89	37.04	5261	5288
nl63995_curated_1.5_5_RIGHT	ATATGCAGGAGCTGTGGGTTGA	1	22	61.94	50	6794	6816
nl63995_curated_1.5_6_LEFT	TTGGAAGCACATTCGTGATCCT	2	22	60.47	45.45	6296	6318
nl63995_curated_1.5_6_RIGHT	ACACCAAACTTAGCCTCATGCC	2	22	61.32	50	7759	7781
nl63995_curated_1.5_7_LEFT	ACAGGGTGCTGGTTTTAAACGT	1	22	61.13	45.45	7547	7569
nl63995_curated_1.5_7_RIGHT	TACCATAACAGACGCGAACCAC	1	22	60.85	50	9036	9058
nl63995_curated_1.5_8_LEFT	GTGGTAGTGCTAGTGAGGCTGA	2	22	61.65	54.55	8854	8876
nl63995_curated_1.5_8_RIGHT	TGGCACCAATGTACCAATCACT	2	22	60.41	45.45	10392	10414
nl63995_curated_1.5_9_LEFT	GCTGACCATTTTAACTATAATGTTTCAGT	1	29	59.67	31.03	10167	10196
nl63995_curated_1.5_9_RIGHT	AAAACACCACCATCACCCTCAG	1	22	60.94	50	11614	11636
nl63995_curated_1.5_10_LEFT	TGCTGGAGTTGTTTGGACACTT	2	22	60.8	45.45	11429	11451
nl63995_curated_1.5_10_RIGHT	TGATGTACAACAGGGAACACCC	2	22	60.41	50	12967	12989
nl63995_curated_1.5_11_LEFT	TCTATGTGATGCGATGGTTGCT	1	22	60.34	45.45	12853	12875
nl63995_curated_1.5_11_RIGHT	AGAAGTCGTACCACCTGGCTTA	1	22	61	50	14308	14330
nl63995_curated_1.5_12_LEFT	TGATTTCAGCCATGGTGTTGGG	2	22	61.59	50	14178	14200
nl63995_curated_1.5_12_RIGHT	ACCTTCTCAAAGATGAACTCACCT	2	24	59.98	41.67	15664	15688
nl63995_curated_1.5_13_LEFT	GCTTTTGCAACTCTTAAAGAGGTTG	1	25	59.91	40	15527	15552
nl63995_curated_1.5_13_RIGHT	ACCTATTTGAACAGCTAAATCACCTG	1	26	60.06	38.46	16977	17003
nl63995_curated_1.5_14_LEFT	GCTATAACACGTGCTAAGAAGGGT	2	24	61	45.83	16772	16796
nl63995_curated_1.5_14_RIGHT	TGTTTTGAACAAACAGCACCACC	2	23	61.11	43.48	18275	18298
nl63995_curated_1.5_15_LEFT	ACATGCGTTTCATACACCAGCA	1	22	61.31	45.45	18118	18140
nl63995_curated_1.5_15_RIGHT	ACGCATATTATGAGGTACGCACA	1	23	60.5	43.48	19629	19652
nl63995_curated_1.5_16_LEFT	GTCTGCTGAATGGAAGTGTGGT	2	22	60.99	50	19456	19478
nl63995_curated_1.5_16_RIGHT	ACCATTACAATCATCACAAACAGTGT	2	26	60.18	34.62	20963	20989
nl63995_curated_1.5_17_LEFT	TGCTTTTGCTCTCCATACTGGT	1	22	60.14	45.45	20574	20596
nl63995_curated_1.5_17_RIGHT	GGAAAATTACAACTACCAGGCACT	1	24	59.56	41.67	22061	22085
nl63995_curated_1.5_18_LEFT	CTGCATCTTTTGGTGGTTCTTGT	2	23	60.18	43.48	21821	21844
nl63995_curated_1.5_18_RIGHT	GCCTCTGCAGTTTGTGTAATAGC	2	23	60.43	47.83	23331	23354
nl63995_curated_1.5_19_LEFT	TATTGCTGACCTTGCTTGTGCT	1	22	61	45.45	23048	23070
nl63995_curated_1.5_19_RIGHT	TGTCACGCAAGACAGTAACATCA	1	23	60.74	43.48	24496	24519
nl63995_curated_1.5_20_LEFT	ATGCGAGGTTGTTGTGATTGTG	2	22	60.21	45.45	24345	24367
nl63995_curated_1.5_20_RIGHT	ATTAACAGAGCGACCAACACGG	2	22	61.36	50	25858	25880
nl63995_curated_1.5_21_LEFT	ACGATGTCTAATAGTAGTGTGCCTC	1	25	60.37	44	25313	25338
nl63995_curated_1.5_21_RIGHT	GCTGTGGAAAACCTTTGGCATC	1	22	61.05	50	26814	26836