Primer Name	Sequence	Pool	Length	Tm	GC%	Start	End
oc43995_curated_1.5_1_LEFT	TGTAATCTATGCTTGTGGGCGT	1	22	60.28	45.45	52	74
oc43995_curated_1.5_1_RIGHT	CCTGCTGCACTCTTAGTATGCA	1	22	60.6	50	1486	1508
oc43995_curated_1.5_2_LEFT	TGCGAACAAGACTCGTGTGATT	2	22	60.98	45.45	1344	1366
oc43995_curated_1.5_2_RIGHT	TCCACTTCAAACACTCCACACG	2	22	61.18	50	2839	2861
oc43995_curated_1.5_3_LEFT	AAGCATGGAGAGTTCCTTGTGC	1	22	61.32	50	2701	2723
oc43995_curated_1.5_3_RIGHT	CAATCTCCAGTAGCACAAACTCCT	1	24	60.89	45.83	4169	4193
oc43995_curated_1.5_4_LEFT	GTTGTAAACCCTGCTAATGGCC	2	22	60.01	50	4056	4078
oc43995_curated_1.5_4_RIGHT	CGCAAGAACAGTCCACGGTATA	2	22	60.59	50	5505	5527
oc43995_curated_1.5_5_LEFT	TCAAGTTGATTTGACTGGGGCA	1	22	60.61	45.45	5372	5394
oc43995_curated_1.5_5_RIGHT	TCCACTGTGCAATCTTACCAACA	1	23	60.69	43.48	6869	6892
oc43995_curated_1.5_6_LEFT	TATGGTTGCTAGAGGTGCTTGC	2	22	60.86	50	6749	6771
oc43995_curated_1.5_6_RIGHT	TTACCCTGCACATGCTTTGCA	2	21	61.2	47.62	8216	8237
oc43995_curated_1.5_7_LEFT	GCTGTGCTCGTAAAAGTTGTTCT	1	23	60.25	43.48	8032	8055
oc43995_curated_1.5_7_RIGHT	AGCATGATTTGAAACAACAACAGCT	1	25	61.06	36	9563	9588
oc43995_curated_1.5_8_LEFT	TGTGTTTCAAGTTTACCCCACACT	2	24	61.14	41.67	9407	9431
oc43995_curated_1.5_8_RIGHT	ACATAGTCCATTTCACAAATGCTGT	2	25	59.91	36	10893	10918
oc43995_curated_1.5_9_LEFT	TGGTTTCCAAGGACGTCAGATT	1	22	60.08	45.45	10721	10743
oc43995_curated_1.5_9_RIGHT	AGTTTGCAAGGCAGAAACAACC	1	22	60.6	45.45	12194	12216
oc43995_curated_1.5_10_LEFT	CTTGATGAGGCGCGTTTTAGTG	2	22	60.65	50	12009	12031
oc43995_curated_1.5_10_RIGHT	CGTGTTCAGCCACAAACTTACA	2	22	59.82	45.45	13553	13575
oc43995_curated_1.5_11_LEFT	CCGTTTTCAGCGTGTTGATGAG	1	22	60.84	50	13438	13460
oc43995_curated_1.5_11_RIGHT	CAACAGTGCGGGCTCTATTCTT	1	22	61.12	50	14915	14937
oc43995_curated_1.5_12_LEFT	AAGCCAGGCTCTATTATGAAGCA	2	23	60.12	43.48	14796	14819
oc43995_curated_1.5_12_RIGHT	TCATTTACATCACATCCTGGTGCA	2	24	60.89	41.67	16213	16237
oc43995_curated_1.5_13_LEFT	CATTACGTTGTGGCAGTTGCAT	1	22	60.53	45.45	16098	16120
oc43995_curated_1.5_13_RIGHT	ACAGCTTTATGCCACAAAGGGT	1	22	60.94	45.45	17565	17587
oc43995_curated_1.5_14_LEFT	CAGTGTCCGCCTTGGTTTATGA	2	22	61.05	50	17409	17431
oc43995_curated_1.5_14_RIGHT	CAGACTTAACAATTGGTTGGGCA	2	23	59.93	43.48	18916	18939
oc43995_curated_1.5_15_LEFT	TGCAGCGTGTGATTCTTAAAGC	1	22	60.27	45.45	18801	18823
oc43995_curated_1.5_15_RIGHT	TTGGAAGTTTGCTGTCTTCGGT	1	22	60.86	45.45	20283	20305
oc43995_curated_1.5_16_LEFT	ACACAAAGCCGTGTTATTAGCTCT	2	24	61.12	41.67	20102	20126
oc43995_curated_1.5_16_RIGHT	AAGACTAATGTGTGGCGCTGTT	2	22	60.99	45.45	21598	21620
oc43995_curated_1.5_17_LEFT	GTTTGGAACGGGGGTGCTTATA	1	22	60.8	50	21263	21285
oc43995_curated_1.5_17_RIGHT	CAAAAGTAAGGCTGCGATACACA	1	23	59.81	43.48	22728	22751
oc43995_curated_1.5_18_LEFT	TCATCTAAAGCTGGCAACTCCA	2	22	59.88	45.45	22525	22547
oc43995_curated_1.5_18_RIGHT	TGGTTGTACTACCACACTATAGGATG	2	26	60.12	42.31	24028	24054
oc43995_curated_1.5_19_LEFT	CCTACTTCAGGTTCCACATATCGT	1	24	60.22	45.83	23832	23856
oc43995_curated_1.5_19_RIGHT	TAACAGCAAGACCCGAACAGTG	1	22	60.99	50	25275	25297
oc43995_curated_1.5_20_LEFT	CCTGCAGGTGTTTTTACCAATCA	2	23	59.93	43.48	25041	25064
oc43995_curated_1.5_20_RIGHT	AAAATGGTACACCTGCTGCTGC	2	22	62.16	50	26553	26575
oc43995_curated_1.5_21_LEFT	AGGGACCTCATTTGTGTGCAAA	1	22	60.87	45.45	26430	26452
oc43995_curated_1.5_21_RIGHT	TTGATTACGGCACCAAGCATGA	1	22	61.06	45.45	27893	27915
oc43995_curated_1.5_22_LEFT	AACTTCACATGACGACTAAGTTCG	2	24	59.63	41.67	27671	27695
oc43995_curated_1.5_22_RIGHT	TTGAGCTCTTCTACCCCTGGTT	2	22	60.95	50	29162	29184
oc43995_curated_1.5_23_LEFT	ATGGACACCGCATTGTTGAGAA	1	22	61	45.45	29010	29032
oc43995_curated_1.5_23_RIGHT	AGCAGCAAGACATCCATTCTGA	1	22	60.21	45.45	30467	30489